########################
#......................#
#..####............#####
#..#..................##
#..#..####...#####...##
#..#..................##
#..####............#####
#......................#
########################
